Amazonas|AMA
Antioquia|ANT
Arauca|ARA
Archipiélago de San Andrés|SAP
Atlántico|ATL
Bogotá D.C.|DC
Bolívar|BOL
Boyacá|BOY
Caldas|CAL
Caquetá|CAQ
Casanare|CAS
Cauca|CAU
Cesar|CES
Chocó|CHO
Córdoba|COR
Cundinamarca|CUN
Guainía|GUA
Guaviare|GUV
Huila|HUI
La Guajira|LAG
Magdalena|MAG
Meta|MET
Nariño|NAR
Norte de Santander|NSA
Putumayo|PUT
Quindío|QUI
Risaralda|RIS
Santander|SAN
Sucre|SUC
Tolima|TOL
Valle del Cauca|VAC
Vaupés|VAU
Vichada|VID