Aguascalientes|AGU
Baja California|BCN
Baja California Sur|BCS
Campeche|CAM
Ciudad de México|DIF
Chiapas|CHP
Chihuahua|CHH
Coahuila de Zaragoza|COA
Colima|COL
Durango|DUR
Estado de México|MEX
Guanajuato|GUA
Guerrero|GRO
Hidalgo|HID
Jalisco|JAL
Michoacán de Ocampo|MIC
Morelos|MOR
Nayarit|NAY
Nuevo León|NLE
Oaxaca|OAX
Puebla|PUE
Querétaro de Arteaga|QUE
Quintana Roo|ROO
San Luis Potosí|SLP
Sinaloa|SIN
Sonora|SON
Tabasco|TAB
Tamaulipas|TAM
Tlaxcala|TLA
Veracruz|VER
Yucatán|YUC
Zacatecas|ZAC